000000000000000000000000000000000000011000000000000000000000000000000000
000000000000000000000000000000000011111111000000000000000000000000000000
000000000000000000001100111111111111111111000000000000000000000000000000
000000000000000000111111001111111111111111111100000000000000000000000000
000000000000000011111111110011111111111111111111000000000000000000000000
000000000000000111111111111110111111111111111111110000000000000000000000
000000000000001111111111111111001111111111111111111100000000000000000000
000000111111111111111111111111001111111111111111111111000000000000000000
000000011111111111111111111111111011111111111111111111110000000000000000
000000011111111111111111111111111001111111111111111111111000000000000000
000000000111111111111111111111111111101111111111111111111111000000000000
000000000001111111111111111111111111101111111111111111111111110000000000
000000000000000111111111111111111111100011111111111111110000001100000000
000000000000000000011111111111111111100011000000000000001111111111000000
000000000000000111101100001111111111011111111111111001111111111110000000
000000000000001101111111111000000001111111111111111011111111111111000000
000000000000111111111111111111001111111111111111110011111111111111000000
000000000011111111111111111111110011111111111100111111111111111111000000
000000000000111111111111111111001111111111110011111111111111111111000000
000000000000000111111111111110111111111111110011111111111111111111000000
000000000000000011111111111111001111111111110011111111111111111111000000
000000000000000001111111111111111011111111000111111111111111111111111000
000000000000000000111111000001111110000000011111111110000000011111111110
000000000000000000011001111110000000111111000011111101111110011111111000
000000000000000000001111111111111111111111110011110011111111011111111000
000000000000000000011111111111111111111110000111111001111110111111110000
000000000000000000111111111111111111110011110000000011000000011111100000
000000000000000001111111111111111110011111111111111111111011110011000000
000000000000000011111111111111110011111111111111111111110111111110000000
000000000000000111111111111111100111111111111111111111100011111100000000
000000000000001100111111111111001111111111111111111100011000011000000000
000000000000011110000000000000110011111111111111110011111111000000000000
000000000000111111111111111111110011111111111111110001111110000000000000
000000000001111111111111111111111001111111111111100000000110000000000000
000000000000111111111111111111111100111111110000000000000000000000000000
000000000000111111111111111111011111111110000000000000000000000000000000
000000000000001111111111111111000000000011000000000000000000000000000000
000000000000000000111111110000000000000000000000000000000000000000000000
000000000000000000000000000000000000000000000000000000000000000000000000
000000000000000000000000000000000000000000000000000000000000000000000000
000000000000000111111110000000000000000000000000000000000000000000000000
000000000000111111111111000000000000000000000000000000000000000000000000
000000000001111111111111100000000000000000000000000000000000000000000000
000000000000011111111000000000000000000000000000000000000000000000000000